
======================
ğŸ–¥ï¸ Comandos CMD (Windows)
======================

dir                  -> Lista arquivos e pastas do diretÃ³rio atual
cd                   -> Muda de diretÃ³rio (cd .. volta uma pasta)
cls                  -> Limpa a tela do terminal
mkdir nome           -> Cria uma nova pasta
del nome             -> Deleta um arquivo
rmdir nome           -> Remove uma pasta vazia
echo texto           -> Exibe uma mensagem no terminal
exit                 -> Fecha o terminal
copy arquivo destino -> Copia um arquivo
move arquivo destino -> Move/renomeia um arquivo
ipconfig             -> Mostra as configuraÃ§Ãµes de rede
ping endereÃ§o        -> Testa conexÃ£o com um servidor
tasklist             -> Mostra todos os processos em execuÃ§Ã£o
taskkill /PID n      -> Encerra um processo pelo ID

======================
ğŸ§¬ Comandos Git
======================

git init              -> Inicia um repositÃ³rio Git
git clone URL         -> Clona um repositÃ³rio remoto
git status            -> Mostra o estado atual dos arquivos
git add nome          -> Adiciona arquivo Ã  staging area
git add .             -> Adiciona todos os arquivos modificados
git commit -m "msg"   -> Salva mudanÃ§as com uma mensagem
git push              -> Envia commits para o repositÃ³rio remoto
git pull              -> Atualiza o repositÃ³rio local com o remoto
git log               -> Mostra histÃ³rico de commits
git branch            -> Lista os branches existentes
git checkout nome     -> Muda para um branch
git checkout -b nome  -> Cria e muda para um novo branch
git merge nome        -> Junta um branch ao atual
git reset --hard      -> Reseta tudo para o Ãºltimo commit
git stash             -> Salva alteraÃ§Ãµes nÃ£o commitadas temporariamente
